x.......................................x
x.......................................x
xx.......................................x
xx.......................................x
xx.......................................x
xx.......................................x
xx.......................................x
xx.......................................x
xx.......................................x
xx.......................................x
xx.......................................x
xx.......................................x
xx.......................................x
xx.......................................x
xx.......................................x
xx.......................................x
xx.......................................x
xx.......................................x
xx.......................................x
xx.......................................x
xx.......................................x                               
xx.......................................x
xxxxxxxxxxxxxxxxxxxxxxxxxxxxxxxxxxxxxxxxxx